222222222222222
222333333333222
222333333333222
222222222333222
224451222333222
224551244442222
222222222222222
224411111115522
222214441115522
224414441115522
224411111115522
222215555555522
224415555555522
222211111111122
222222222222222