222222222222222
222333333333222
222333333333222
222222222333222
224451222333222
224551222222222
222222222222222
222211111115522
222214441115522
222214441115522
222211111115522
222215555555522
222215555555522
222211111111122
222222222222222